{
    "mistress-rebeccas-world-18th-march-2018": {
        "00": {},
        "01": {},
        "02": {},
        "03": {},
        "04": {},
        "05": {},
        "06": {},
        "07": {},
        "08": {},
        "09": {},
        "10": {},
        "11": {},
        "12": {},
        "13": {},
        "14": {}
    },
    "mistress-rebeccas-world-21st-december-2017": {
        "00": {},
        "01": {},
        "02": {},
        "03": {},
        "04": {},
        "05": {},
        "06": {},
        "07": {},
        "08": {},
        "09": {},
        "10": {},
        "11": {},
        "12": {},
        "13": {},
        "14": {}
    },
    "mistress-rebeccas-world-3rd-february-2019": {
        "00": {},
        "01": {},
        "02": {},
        "03": {},
        "04": {},
        "05": {},
        "06": {},
        "07": {},
        "08": {},
        "09": {},
        "10": {},
        "11": {},
        "12": {}
    },
    "mistress-rebeccas-world-5th-february-2018": {
        "00": {},
        "01": {},
        "02": {},
        "03": {},
        "04": {},
        "05": {},
        "06": {},
        "07": {},
        "08": {},
        "09": {},
        "10": {},
        "11": {},
        "12": {},
        "13": {}
    },
    "mistress-rebeccas-world-8th-june-2018": {
        "00": {},
        "01": {},
        "02": {},
        "03": {},
        "04": {},
        "05": {},
        "06": {},
        "07": {},
        "08": {},
        "09": {},
        "10": {},
        "11": {},
        "12": {},
        "13": {}
    },
    "mistress-rebeccas-world-8th-november-2017": {
        "00": {},
        "01": {},
        "02": {},
        "03": {},
        "04": {},
        "05": {},
        "06": {},
        "07": {},
        "08": {},
        "09": {},
        "10": {},
        "11": {},
        "12": {},
        "13": {}
    },
    "mistress-rebeccas-world-9th-september-2018": {
        "00": {},
        "01": {},
        "02": {},
        "03": {},
        "04": {},
        "05": {},
        "06": {},
        "07": {}
    }
}